# $Id: widgets.txt,v 1.2 2003/06/26 11:51:08 rda Exp rda $
# format: full.widget.name	WidgetClassName
# N.b., it is conventional to use the application class name "Xpp"
# not the application name "xpp" in resource files
# Use a "*" as a wildcard to match zero or more components of a resource name
# Use a "?" as a wildcard for exactly one component of a resource name.
# E.g.,
#	 "Xpp*copy.foreground: red" makes the copy item in all the edit menus red
# 	"Xpp*journal*copy.foreground: red" makes the copy item in the journal popup edit menu only red
#	"Xpp*popup-edit-menu.copy.foreground: red" makes the copy item in all the popup edit menus red
# Motif separator and sash widgets are not listed.
xpp	ApplicationShell
xpp.frame	XmMainWindow
xpp.frame.filesel_popup	XmDialogShell
xpp.frame.filesel_popup.filesel	XmFileSelectionBox
xpp.frame.filesel_popup.filesel.Apply	XmPushButtonGadget
xpp.frame.filesel_popup.filesel.Cancel	XmPushButtonGadget
xpp.frame.filesel_popup.filesel.Dir	XmLabelGadget
xpp.frame.filesel_popup.filesel.DirListSW	XmScrolledWindow
xpp.frame.filesel_popup.filesel.DirListSW.DirList	XmList
xpp.frame.filesel_popup.filesel.DirListSW.HorScrollBar	XmScrollBar
xpp.frame.filesel_popup.filesel.DirListSW.VertScrollBar	XmScrollBar
xpp.frame.filesel_popup.filesel.FilterLabel	XmLabelGadget
xpp.frame.filesel_popup.filesel.FilterText	XmTextField
xpp.frame.filesel_popup.filesel.Help	XmPushButtonGadget
xpp.frame.filesel_popup.filesel.Items	XmLabelGadget
xpp.frame.filesel_popup.filesel.ItemsListSW	XmScrolledWindow
xpp.frame.filesel_popup.filesel.ItemsListSW.HorScrollBar	XmScrollBar
xpp.frame.filesel_popup.filesel.ItemsListSW.ItemsList	XmList
xpp.frame.filesel_popup.filesel.ItemsListSW.VertScrollBar	XmScrollBar
xpp.frame.filesel_popup.filesel.OK	XmPushButtonGadget
xpp.frame.filesel_popup.filesel.Selection	XmLabelGadget
xpp.frame.filesel_popup.filesel.Separator	XmSeparatorGadget
xpp.frame.filesel_popup.filesel.Text	XmTextField
xpp.frame.mainpanes	XmPanedWindow
xpp.frame.mainpanes.journalSW	XmScrolledWindow
xpp.frame.mainpanes.journalSW.journal	XmText
xpp.frame.mainpanes.journalSW.journal.popup_popup-edit-menu	XmMenuShell
xpp.frame.mainpanes.journalSW.journal.popup_popup-edit-menu.popup-edit-menu	XmRowColumn
xpp.frame.mainpanes.journalSW.journal.popup_popup-edit-menu.popup-edit-menu.clear	XmPushButtonGadget
xpp.frame.mainpanes.journalSW.journal.popup_popup-edit-menu.popup-edit-menu.copy	XmPushButtonGadget
xpp.frame.mainpanes.journalSW.VertScrollBar	XmScrollBar
xpp.frame.mainpanes.Sash	XmSash
xpp.frame.mainpanes.scriptpanes	XmPanedWindow
xpp.frame.mainpanes.scriptpanes.infobar	XmForm
xpp.frame.mainpanes.scriptpanes.infobar.filename	XmRowColumn
xpp.frame.mainpanes.scriptpanes.infobar.filename.filelabel	XmLabel
xpp.frame.mainpanes.scriptpanes.infobar.filename.namestring	XmTextField
xpp.frame.mainpanes.scriptpanes.infobar.filename.namestring.popup_popup-edit-menu	XmMenuShell
xpp.frame.mainpanes.scriptpanes.infobar.filename.namestring.popup_popup-edit-menu.popup-edit-menu	XmRowColumn
xpp.frame.mainpanes.scriptpanes.infobar.filename.namestring.popup_popup-edit-menu.popup-edit-menu.clear	XmPushButtonGadget
xpp.frame.mainpanes.scriptpanes.infobar.filename.namestring.popup_popup-edit-menu.popup-edit-menu.copy	XmPushButtonGadget
xpp.frame.mainpanes.scriptpanes.infobar.infolabel	XmLabel
xpp.frame.mainpanes.scriptpanes.infobar.linenumber	XmLabel
xpp.frame.mainpanes.scriptpanes.infobar.linenumber.popup_line-number-menu	XmMenuShell
xpp.frame.mainpanes.scriptpanes.infobar.linenumber.popup_line-number-menu.line-number-menu	XmRowColumn
xpp.frame.mainpanes.scriptpanes.infobar.linenumber.popup_line-number-menu.line-number-menu.stop	XmPushButtonGadget
xpp.frame.mainpanes.scriptpanes.infobar.logo	XmLabel
xpp.frame.mainpanes.scriptpanes.Sash	XmSash
xpp.frame.mainpanes.scriptpanes.scriptSW	XmScrolledWindow
xpp.frame.mainpanes.scriptpanes.scriptSW.script	XmText
xpp.frame.mainpanes.scriptpanes.scriptSW.script.ok_popup	XmDialogShell
xpp.frame.mainpanes.scriptpanes.scriptSW.script.ok_popup.ok	XmMessageBox
xpp.frame.mainpanes.scriptpanes.scriptSW.script.ok_popup.ok.Cancel	XmPushButtonGadget
xpp.frame.mainpanes.scriptpanes.scriptSW.script.ok_popup.ok.Help	XmPushButtonGadget
xpp.frame.mainpanes.scriptpanes.scriptSW.script.ok_popup.ok.Message	XmLabelGadget
xpp.frame.mainpanes.scriptpanes.scriptSW.script.ok_popup.ok.OK	XmPushButtonGadget
xpp.frame.mainpanes.scriptpanes.scriptSW.script.ok_popup.ok.Separator	XmSeparatorGadget
xpp.frame.mainpanes.scriptpanes.scriptSW.script.ok_popup.ok.Symbol	XmLabelGadget
xpp.frame.mainpanes.scriptpanes.scriptSW.script.popup_popup-edit-menu	XmMenuShell
xpp.frame.mainpanes.scriptpanes.scriptSW.script.popup_popup-edit-menu.popup-edit-menu	XmRowColumn
xpp.frame.mainpanes.scriptpanes.scriptSW.script.popup_popup-edit-menu.popup-edit-menu.clear	XmPushButtonGadget
xpp.frame.mainpanes.scriptpanes.scriptSW.script.popup_popup-edit-menu.popup-edit-menu.copy	XmPushButtonGadget
xpp.frame.mainpanes.scriptpanes.scriptSW.script.popup_popup-edit-menu.popup-edit-menu.cut	XmPushButtonGadget
xpp.frame.mainpanes.scriptpanes.scriptSW.script.popup_popup-edit-menu.popup-edit-menu.paste	XmPushButtonGadget
xpp.frame.mainpanes.scriptpanes.scriptSW.script.popup_popup-edit-menu.popup-edit-menu.redo	XmPushButtonGadget
xpp.frame.mainpanes.scriptpanes.scriptSW.script.popup_popup-edit-menu.popup-edit-menu.undo	XmPushButtonGadget
xpp.frame.mainpanes.scriptpanes.scriptSW.script.xpp-Options	XmDialogShell
xpp.frame.mainpanes.scriptpanes.scriptSW.script.xpp-Options.shell-row-col	XmRowColumn
xpp.frame.mainpanes.scriptpanes.scriptSW.script.xpp-Options.shell-row-col.add-new-line-frame	XmFrame
xpp.frame.mainpanes.scriptpanes.scriptSW.script.xpp-Options.shell-row-col.add-new-line-frame.add-new-line-radio-buttons	XmRowColumn
xpp.frame.mainpanes.scriptpanes.scriptSW.script.xpp-Options.shell-row-col.add-new-line-frame.add-new-line-radio-buttons.button_0	XmToggleButtonGadget
xpp.frame.mainpanes.scriptpanes.scriptSW.script.xpp-Options.shell-row-col.add-new-line-frame.add-new-line-radio-buttons.button_1	XmToggleButtonGadget
xpp.frame.mainpanes.scriptpanes.scriptSW.script.xpp-Options.shell-row-col.add-new-line-frame.add-new-line-radio-buttons.button_2	XmToggleButtonGadget
xpp.frame.mainpanes.scriptpanes.scriptSW.script.xpp-Options.shell-row-col.app-frame	XmFrame
xpp.frame.mainpanes.scriptpanes.scriptSW.script.xpp-Options.shell-row-col.app-frame.app-row-col	XmRowColumn
xpp.frame.mainpanes.scriptpanes.scriptSW.script.xpp-Options.shell-row-col.app-frame.app-row-col.command-form	XmForm
xpp.frame.mainpanes.scriptpanes.scriptSW.script.xpp-Options.shell-row-col.app-frame.app-row-col.command-form.command-line	XmText
xpp.frame.mainpanes.scriptpanes.scriptSW.script.xpp-Options.shell-row-col.app-frame.app-row-col.command-form.command-line-label	XmLabel
xpp.frame.mainpanes.scriptpanes.scriptSW.script.xpp-Options.shell-row-col.app-frame.app-row-col.command-form.command-line.popup_popup-edit-menu	XmMenuShell
xpp.frame.mainpanes.scriptpanes.scriptSW.script.xpp-Options.shell-row-col.app-frame.app-row-col.command-form.command-line.popup_popup-edit-menu.popup-edit-menu	XmRowColumn
xpp.frame.mainpanes.scriptpanes.scriptSW.script.xpp-Options.shell-row-col.app-frame.app-row-col.command-form.command-line.popup_popup-edit-menu.popup-edit-menu.clear	XmPushButtonGadget
xpp.frame.mainpanes.scriptpanes.scriptSW.script.xpp-Options.shell-row-col.app-frame.app-row-col.command-form.command-line.popup_popup-edit-menu.popup-edit-menu.copy	XmPushButtonGadget
xpp.frame.mainpanes.scriptpanes.scriptSW.script.xpp-Options.shell-row-col.app-frame.app-row-col.command-form.command-line.popup_popup-edit-menu.popup-edit-menu.cut	XmPushButtonGadget
xpp.frame.mainpanes.scriptpanes.scriptSW.script.xpp-Options.shell-row-col.app-frame.app-row-col.command-form.command-line.popup_popup-edit-menu.popup-edit-menu.paste	XmPushButtonGadget
xpp.frame.mainpanes.scriptpanes.scriptSW.script.xpp-Options.shell-row-col.app-frame.app-row-col.journal-form	XmForm
xpp.frame.mainpanes.scriptpanes.scriptSW.script.xpp-Options.shell-row-col.app-frame.app-row-col.journal-form.journal-max	XmText
xpp.frame.mainpanes.scriptpanes.scriptSW.script.xpp-Options.shell-row-col.app-frame.app-row-col.journal-form.journal-max-label	XmLabel
xpp.frame.mainpanes.scriptpanes.scriptSW.script.xpp-Options.shell-row-col.app-frame.app-row-col.journal-form.journal-max.popup_popup-edit-menu	XmMenuShell
xpp.frame.mainpanes.scriptpanes.scriptSW.script.xpp-Options.shell-row-col.app-frame.app-row-col.journal-form.journal-max.popup_popup-edit-menu.popup-edit-menu	XmRowColumn
xpp.frame.mainpanes.scriptpanes.scriptSW.script.xpp-Options.shell-row-col.app-frame.app-row-col.journal-form.journal-max.popup_popup-edit-menu.popup-edit-menu.clear	XmPushButtonGadget
xpp.frame.mainpanes.scriptpanes.scriptSW.script.xpp-Options.shell-row-col.app-frame.app-row-col.journal-form.journal-max.popup_popup-edit-menu.popup-edit-menu.copy	XmPushButtonGadget
xpp.frame.mainpanes.scriptpanes.scriptSW.script.xpp-Options.shell-row-col.app-frame.app-row-col.journal-form.journal-max.popup_popup-edit-menu.popup-edit-menu.cut	XmPushButtonGadget
xpp.frame.mainpanes.scriptpanes.scriptSW.script.xpp-Options.shell-row-col.app-frame.app-row-col.journal-form.journal-max.popup_popup-edit-menu.popup-edit-menu.paste	XmPushButtonGadget
xpp.frame.mainpanes.scriptpanes.scriptSW.script.xpp-Options.shell-row-col.button-frame	XmFrame
xpp.frame.mainpanes.scriptpanes.scriptSW.script.xpp-Options.shell-row-col.button-frame.app-row-col	XmForm
xpp.frame.mainpanes.scriptpanes.scriptSW.script.xpp-Options.shell-row-col.button-frame.app-row-col.Apply	XmPushButton
xpp.frame.mainpanes.scriptpanes.scriptSW.script.xpp-Options.shell-row-col.button-frame.app-row-col.Current	XmPushButton
xpp.frame.mainpanes.scriptpanes.scriptSW.script.xpp-Options.shell-row-col.button-frame.app-row-col.Dismiss	XmPushButton
xpp.frame.mainpanes.scriptpanes.scriptSW.script.xpp-Options.shell-row-col.button-frame.app-row-col.Help	XmPushButton
xpp.frame.mainpanes.scriptpanes.scriptSW.script.xpp-Options.shell-row-col.button-frame.app-row-col.Original	XmPushButton
xpp.frame.mainpanes.scriptpanes.scriptSW.script.xpp-Options.shell-row-col.edit-frame	XmFrame
xpp.frame.mainpanes.scriptpanes.scriptSW.script.xpp-Options.shell-row-col.edit-frame.edit-row-col	XmRowColumn
xpp.frame.mainpanes.scriptpanes.scriptSW.script.xpp-Options.shell-row-col.edit-frame.edit-row-col.delete-backups	XmToggleButton
xpp.frame.mainpanes.scriptpanes.scriptSW.script.xpp-Options.shell-row-col.edit-frame.edit-row-col.read-only	XmToggleButton
xpp.frame.mainpanes.scriptpanes.scriptSW.script.xpp-Options.shell-row-col.edit-frame.edit-row-col.take-backups	XmToggleButton
xpp.frame.mainpanes.scriptpanes.scriptSW.script.xpp-Options.shell-row-col.edit-frame.file-type-menu	XmRowColumn
xpp.frame.mainpanes.scriptpanes.scriptSW.script.xpp-Options.shell-row-col.edit-frame.file-type-menu.OptionButton	XmCascadeButtonGadget
xpp.frame.mainpanes.scriptpanes.scriptSW.script.xpp-Options.shell-row-col.edit-frame.file-type-menu.OptionLabel	XmLabelGadget
xpp.frame.mainpanes.scriptpanes.scriptSW.script.xpp-Options.shell-row-col.search-replace-frame	XmFrame
xpp.frame.mainpanes.scriptpanes.scriptSW.script.xpp-Options.shell-row-col.search-replace-frame.search-replace-row-col	XmRowColumn
xpp.frame.mainpanes.scriptpanes.scriptSW.script.xpp-Options.shell-row-col.search-replace-frame.search-replace-row-col.ignore-case	XmToggleButton
xpp.frame.mainpanes.scriptpanes.scriptSW.script.xpp-Options.shell-row-col.search-replace-frame.search-replace-row-col.use-regular-expressions	XmToggleButton
xpp.frame.mainpanes.scriptpanes.scriptSW.script.xpp-Palette	XmDialogShell
xpp.frame.mainpanes.scriptpanes.scriptSW.script.xpp-Palette.form	XmForm
xpp.frame.mainpanes.scriptpanes.scriptSW.script.xpp-Palette.form.char80	XmPushButtonGadget
xpp.frame.mainpanes.scriptpanes.scriptSW.script.xpp-Palette.form.char81	XmPushButtonGadget
xpp.frame.mainpanes.scriptpanes.scriptSW.script.xpp-Palette.form.char82	XmPushButtonGadget
xpp.frame.mainpanes.scriptpanes.scriptSW.script.xpp-Palette.form.char83	XmPushButtonGadget
xpp.frame.mainpanes.scriptpanes.scriptSW.script.xpp-Palette.form.char84	XmPushButtonGadget
xpp.frame.mainpanes.scriptpanes.scriptSW.script.xpp-Palette.form.char85	XmPushButtonGadget
xpp.frame.mainpanes.scriptpanes.scriptSW.script.xpp-Palette.form.char86	XmPushButtonGadget
xpp.frame.mainpanes.scriptpanes.scriptSW.script.xpp-Palette.form.char87	XmPushButtonGadget
xpp.frame.mainpanes.scriptpanes.scriptSW.script.xpp-Palette.form.char88	XmPushButtonGadget
xpp.frame.mainpanes.scriptpanes.scriptSW.script.xpp-Palette.form.char89	XmPushButtonGadget
xpp.frame.mainpanes.scriptpanes.scriptSW.script.xpp-Palette.form.char8A	XmPushButtonGadget
xpp.frame.mainpanes.scriptpanes.scriptSW.script.xpp-Palette.form.char8B	XmPushButtonGadget
xpp.frame.mainpanes.scriptpanes.scriptSW.script.xpp-Palette.form.char8C	XmPushButtonGadget
xpp.frame.mainpanes.scriptpanes.scriptSW.script.xpp-Palette.form.char8D	XmPushButtonGadget
xpp.frame.mainpanes.scriptpanes.scriptSW.script.xpp-Palette.form.char8E	XmPushButtonGadget
xpp.frame.mainpanes.scriptpanes.scriptSW.script.xpp-Palette.form.char8F	XmPushButtonGadget
xpp.frame.mainpanes.scriptpanes.scriptSW.script.xpp-Palette.form.char90	XmPushButtonGadget
xpp.frame.mainpanes.scriptpanes.scriptSW.script.xpp-Palette.form.char91	XmPushButtonGadget
xpp.frame.mainpanes.scriptpanes.scriptSW.script.xpp-Palette.form.char92	XmPushButtonGadget
xpp.frame.mainpanes.scriptpanes.scriptSW.script.xpp-Palette.form.char93	XmPushButtonGadget
xpp.frame.mainpanes.scriptpanes.scriptSW.script.xpp-Palette.form.char94	XmPushButtonGadget
xpp.frame.mainpanes.scriptpanes.scriptSW.script.xpp-Palette.form.char95	XmPushButtonGadget
xpp.frame.mainpanes.scriptpanes.scriptSW.script.xpp-Palette.form.char96	XmPushButtonGadget
xpp.frame.mainpanes.scriptpanes.scriptSW.script.xpp-Palette.form.char97	XmPushButtonGadget
xpp.frame.mainpanes.scriptpanes.scriptSW.script.xpp-Palette.form.char98	XmPushButtonGadget
xpp.frame.mainpanes.scriptpanes.scriptSW.script.xpp-Palette.form.char99	XmPushButtonGadget
xpp.frame.mainpanes.scriptpanes.scriptSW.script.xpp-Palette.form.char9A	XmPushButtonGadget
xpp.frame.mainpanes.scriptpanes.scriptSW.script.xpp-Palette.form.char9B	XmPushButtonGadget
xpp.frame.mainpanes.scriptpanes.scriptSW.script.xpp-Palette.form.char9C	XmPushButtonGadget
xpp.frame.mainpanes.scriptpanes.scriptSW.script.xpp-Palette.form.char9D	XmPushButtonGadget
xpp.frame.mainpanes.scriptpanes.scriptSW.script.xpp-Palette.form.char9E	XmPushButtonGadget
xpp.frame.mainpanes.scriptpanes.scriptSW.script.xpp-Palette.form.char9F	XmPushButtonGadget
xpp.frame.mainpanes.scriptpanes.scriptSW.script.xpp-Palette.form.charA0	XmPushButtonGadget
xpp.frame.mainpanes.scriptpanes.scriptSW.script.xpp-Palette.form.charA1	XmPushButtonGadget
xpp.frame.mainpanes.scriptpanes.scriptSW.script.xpp-Palette.form.charA2	XmPushButtonGadget
xpp.frame.mainpanes.scriptpanes.scriptSW.script.xpp-Palette.form.charA3	XmPushButtonGadget
xpp.frame.mainpanes.scriptpanes.scriptSW.script.xpp-Palette.form.charA4	XmPushButtonGadget
xpp.frame.mainpanes.scriptpanes.scriptSW.script.xpp-Palette.form.charA5	XmPushButtonGadget
xpp.frame.mainpanes.scriptpanes.scriptSW.script.xpp-Palette.form.charA6	XmPushButtonGadget
xpp.frame.mainpanes.scriptpanes.scriptSW.script.xpp-Palette.form.charA7	XmPushButtonGadget
xpp.frame.mainpanes.scriptpanes.scriptSW.script.xpp-Palette.form.charA8	XmPushButtonGadget
xpp.frame.mainpanes.scriptpanes.scriptSW.script.xpp-Palette.form.charA9	XmPushButtonGadget
xpp.frame.mainpanes.scriptpanes.scriptSW.script.xpp-Palette.form.charAA	XmPushButtonGadget
xpp.frame.mainpanes.scriptpanes.scriptSW.script.xpp-Palette.form.charAB	XmPushButtonGadget
xpp.frame.mainpanes.scriptpanes.scriptSW.script.xpp-Palette.form.charAC	XmPushButtonGadget
xpp.frame.mainpanes.scriptpanes.scriptSW.script.xpp-Palette.form.charAD	XmPushButtonGadget
xpp.frame.mainpanes.scriptpanes.scriptSW.script.xpp-Palette.form.charAE	XmPushButtonGadget
xpp.frame.mainpanes.scriptpanes.scriptSW.script.xpp-Palette.form.charAF	XmPushButtonGadget
xpp.frame.mainpanes.scriptpanes.scriptSW.script.xpp-Palette.form.charB0	XmPushButtonGadget
xpp.frame.mainpanes.scriptpanes.scriptSW.script.xpp-Palette.form.charB1	XmPushButtonGadget
xpp.frame.mainpanes.scriptpanes.scriptSW.script.xpp-Palette.form.charB2	XmPushButtonGadget
xpp.frame.mainpanes.scriptpanes.scriptSW.script.xpp-Palette.form.charB3	XmPushButtonGadget
xpp.frame.mainpanes.scriptpanes.scriptSW.script.xpp-Palette.form.charB4	XmPushButtonGadget
xpp.frame.mainpanes.scriptpanes.scriptSW.script.xpp-Palette.form.charB5	XmPushButtonGadget
xpp.frame.mainpanes.scriptpanes.scriptSW.script.xpp-Palette.form.charB6	XmPushButtonGadget
xpp.frame.mainpanes.scriptpanes.scriptSW.script.xpp-Palette.form.charB7	XmPushButtonGadget
xpp.frame.mainpanes.scriptpanes.scriptSW.script.xpp-Palette.form.charB8	XmPushButtonGadget
xpp.frame.mainpanes.scriptpanes.scriptSW.script.xpp-Palette.form.charB9	XmPushButtonGadget
xpp.frame.mainpanes.scriptpanes.scriptSW.script.xpp-Palette.form.charBA	XmPushButtonGadget
xpp.frame.mainpanes.scriptpanes.scriptSW.script.xpp-Palette.form.charBB	XmPushButtonGadget
xpp.frame.mainpanes.scriptpanes.scriptSW.script.xpp-Palette.form.charBC	XmPushButtonGadget
xpp.frame.mainpanes.scriptpanes.scriptSW.script.xpp-Palette.form.charBD	XmPushButtonGadget
xpp.frame.mainpanes.scriptpanes.scriptSW.script.xpp-Palette.form.charBE	XmPushButtonGadget
xpp.frame.mainpanes.scriptpanes.scriptSW.script.xpp-Palette.form.charBF	XmPushButtonGadget
xpp.frame.mainpanes.scriptpanes.scriptSW.script.xpp-Palette.form.charC0	XmPushButtonGadget
xpp.frame.mainpanes.scriptpanes.scriptSW.script.xpp-Palette.form.charC1	XmPushButtonGadget
xpp.frame.mainpanes.scriptpanes.scriptSW.script.xpp-Palette.form.charC2	XmPushButtonGadget
xpp.frame.mainpanes.scriptpanes.scriptSW.script.xpp-Palette.form.charC3	XmPushButtonGadget
xpp.frame.mainpanes.scriptpanes.scriptSW.script.xpp-Palette.form.charC4	XmPushButtonGadget
xpp.frame.mainpanes.scriptpanes.scriptSW.script.xpp-Palette.form.charC5	XmPushButtonGadget
xpp.frame.mainpanes.scriptpanes.scriptSW.script.xpp-Palette.form.charC6	XmPushButtonGadget
xpp.frame.mainpanes.scriptpanes.scriptSW.script.xpp-Palette.form.charC7	XmPushButtonGadget
xpp.frame.mainpanes.scriptpanes.scriptSW.script.xpp-Palette.form.charC8	XmPushButtonGadget
xpp.frame.mainpanes.scriptpanes.scriptSW.script.xpp-Palette.form.charC9	XmPushButtonGadget
xpp.frame.mainpanes.scriptpanes.scriptSW.script.xpp-Palette.form.charCA	XmPushButtonGadget
xpp.frame.mainpanes.scriptpanes.scriptSW.script.xpp-Palette.form.charCB	XmPushButtonGadget
xpp.frame.mainpanes.scriptpanes.scriptSW.script.xpp-Palette.form.charCC	XmPushButtonGadget
xpp.frame.mainpanes.scriptpanes.scriptSW.script.xpp-Palette.form.charCD	XmPushButtonGadget
xpp.frame.mainpanes.scriptpanes.scriptSW.script.xpp-Palette.form.charCE	XmPushButtonGadget
xpp.frame.mainpanes.scriptpanes.scriptSW.script.xpp-Palette.form.charCF	XmPushButtonGadget
xpp.frame.mainpanes.scriptpanes.scriptSW.script.xpp-Palette.form.charD0	XmPushButtonGadget
xpp.frame.mainpanes.scriptpanes.scriptSW.script.xpp-Palette.form.charD1	XmPushButtonGadget
xpp.frame.mainpanes.scriptpanes.scriptSW.script.xpp-Palette.form.charD2	XmPushButtonGadget
xpp.frame.mainpanes.scriptpanes.scriptSW.script.xpp-Palette.form.charD3	XmPushButtonGadget
xpp.frame.mainpanes.scriptpanes.scriptSW.script.xpp-Palette.form.charD4	XmPushButtonGadget
xpp.frame.mainpanes.scriptpanes.scriptSW.script.xpp-Palette.form.charD5	XmPushButtonGadget
xpp.frame.mainpanes.scriptpanes.scriptSW.script.xpp-Palette.form.charD6	XmPushButtonGadget
xpp.frame.mainpanes.scriptpanes.scriptSW.script.xpp-Palette.form.charD7	XmPushButtonGadget
xpp.frame.mainpanes.scriptpanes.scriptSW.script.xpp-Palette.form.charD8	XmPushButtonGadget
xpp.frame.mainpanes.scriptpanes.scriptSW.script.xpp-Palette.form.charD9	XmPushButtonGadget
xpp.frame.mainpanes.scriptpanes.scriptSW.script.xpp-Palette.form.charDA	XmPushButtonGadget
xpp.frame.mainpanes.scriptpanes.scriptSW.script.xpp-Palette.form.charDB	XmPushButtonGadget
xpp.frame.mainpanes.scriptpanes.scriptSW.script.xpp-Palette.form.charDC	XmPushButtonGadget
xpp.frame.mainpanes.scriptpanes.scriptSW.script.xpp-Palette.form.charDD	XmPushButtonGadget
xpp.frame.mainpanes.scriptpanes.scriptSW.script.xpp-Palette.form.charDE	XmPushButtonGadget
xpp.frame.mainpanes.scriptpanes.scriptSW.script.xpp-Palette.form.charDF	XmPushButtonGadget
xpp.frame.mainpanes.scriptpanes.scriptSW.script.xpp-Palette.form.charE0	XmPushButtonGadget
xpp.frame.mainpanes.scriptpanes.scriptSW.script.xpp-Palette.form.charE1	XmPushButtonGadget
xpp.frame.mainpanes.scriptpanes.scriptSW.script.xpp-Palette.form.charE2	XmPushButtonGadget
xpp.frame.mainpanes.scriptpanes.scriptSW.script.xpp-Palette.form.charE3	XmPushButtonGadget
xpp.frame.mainpanes.scriptpanes.scriptSW.script.xpp-Palette.form.charE4	XmPushButtonGadget
xpp.frame.mainpanes.scriptpanes.scriptSW.script.xpp-Palette.form.charE5	XmPushButtonGadget
xpp.frame.mainpanes.scriptpanes.scriptSW.script.xpp-Palette.form.charE6	XmPushButtonGadget
xpp.frame.mainpanes.scriptpanes.scriptSW.script.xpp-Palette.form.charE7	XmPushButtonGadget
xpp.frame.mainpanes.scriptpanes.scriptSW.script.xpp-Palette.form.charE8	XmPushButtonGadget
xpp.frame.mainpanes.scriptpanes.scriptSW.script.xpp-Palette.form.charE9	XmPushButtonGadget
xpp.frame.mainpanes.scriptpanes.scriptSW.script.xpp-Palette.form.charEA	XmPushButtonGadget
xpp.frame.mainpanes.scriptpanes.scriptSW.script.xpp-Palette.form.charEB	XmPushButtonGadget
xpp.frame.mainpanes.scriptpanes.scriptSW.script.xpp-Palette.form.charEC	XmPushButtonGadget
xpp.frame.mainpanes.scriptpanes.scriptSW.script.xpp-Palette.form.charED	XmPushButtonGadget
xpp.frame.mainpanes.scriptpanes.scriptSW.script.xpp-Palette.form.charEE	XmPushButtonGadget
xpp.frame.mainpanes.scriptpanes.scriptSW.script.xpp-Palette.form.charEF	XmPushButtonGadget
xpp.frame.mainpanes.scriptpanes.scriptSW.script.xpp-Palette.form.charF0	XmPushButtonGadget
xpp.frame.mainpanes.scriptpanes.scriptSW.script.xpp-Palette.form.charF1	XmPushButtonGadget
xpp.frame.mainpanes.scriptpanes.scriptSW.script.xpp-Palette.form.charF2	XmPushButtonGadget
xpp.frame.mainpanes.scriptpanes.scriptSW.script.xpp-Palette.form.charF3	XmPushButtonGadget
xpp.frame.mainpanes.scriptpanes.scriptSW.script.xpp-Palette.form.charF4	XmPushButtonGadget
xpp.frame.mainpanes.scriptpanes.scriptSW.script.xpp-Palette.form.charF5	XmPushButtonGadget
xpp.frame.mainpanes.scriptpanes.scriptSW.script.xpp-Palette.form.charF6	XmPushButtonGadget
xpp.frame.mainpanes.scriptpanes.scriptSW.script.xpp-Palette.form.charF7	XmPushButtonGadget
xpp.frame.mainpanes.scriptpanes.scriptSW.script.xpp-Palette.form.charF8	XmPushButtonGadget
xpp.frame.mainpanes.scriptpanes.scriptSW.script.xpp-Palette.form.charF9	XmPushButtonGadget
xpp.frame.mainpanes.scriptpanes.scriptSW.script.xpp-Palette.form.charFA	XmPushButtonGadget
xpp.frame.mainpanes.scriptpanes.scriptSW.script.xpp-Palette.form.charFB	XmPushButtonGadget
xpp.frame.mainpanes.scriptpanes.scriptSW.script.xpp-Palette.form.charFC	XmPushButtonGadget
xpp.frame.mainpanes.scriptpanes.scriptSW.script.xpp-Palette.form.charFD	XmPushButtonGadget
xpp.frame.mainpanes.scriptpanes.scriptSW.script.xpp-Palette.form.charFE	XmPushButtonGadget
xpp.frame.mainpanes.scriptpanes.scriptSW.script.xpp-Palette.form.charFF	XmPushButtonGadget
xpp.frame.mainpanes.scriptpanes.scriptSW.script.xpp-Search-and-Replace	TransientShell
xpp.frame.mainpanes.scriptpanes.scriptSW.script.xpp-Search-and-Replace.search-replace-paned	XmPanedWindow
xpp.frame.mainpanes.scriptpanes.scriptSW.script.xpp-Search-and-Replace.search-replace-paned.line-number-form	XmForm
xpp.frame.mainpanes.scriptpanes.scriptSW.script.xpp-Search-and-Replace.search-replace-paned.line-number-form.becomes-cursor	XmPushButton
xpp.frame.mainpanes.scriptpanes.scriptSW.script.xpp-Search-and-Replace.search-replace-paned.line-number-form.go-to-line	XmPushButton
xpp.frame.mainpanes.scriptpanes.scriptSW.script.xpp-Search-and-Replace.search-replace-paned.line-number-form.line-number	XmText
xpp.frame.mainpanes.scriptpanes.scriptSW.script.xpp-Search-and-Replace.search-replace-paned.line-number-form.line-number.popup_popup-edit-menu	XmMenuShell
xpp.frame.mainpanes.scriptpanes.scriptSW.script.xpp-Search-and-Replace.search-replace-paned.line-number-form.line-number.popup_popup-edit-menu.popup-edit-menu	XmRowColumn
xpp.frame.mainpanes.scriptpanes.scriptSW.script.xpp-Search-and-Replace.search-replace-paned.line-number-form.line-number.popup_popup-edit-menu.popup-edit-menu.clear	XmPushButtonGadget
xpp.frame.mainpanes.scriptpanes.scriptSW.script.xpp-Search-and-Replace.search-replace-paned.line-number-form.line-number.popup_popup-edit-menu.popup-edit-menu.copy	XmPushButtonGadget
xpp.frame.mainpanes.scriptpanes.scriptSW.script.xpp-Search-and-Replace.search-replace-paned.line-number-form.line-number.popup_popup-edit-menu.popup-edit-menu.cut	XmPushButtonGadget
xpp.frame.mainpanes.scriptpanes.scriptSW.script.xpp-Search-and-Replace.search-replace-paned.line-number-form.line-number.popup_popup-edit-menu.popup-edit-menu.paste	XmPushButtonGadget
xpp.frame.mainpanes.scriptpanes.scriptSW.script.xpp-Search-and-Replace.search-replace-paned.replace	XmText
xpp.frame.mainpanes.scriptpanes.scriptSW.script.xpp-Search-and-Replace.search-replace-paned.replace-form	XmForm
xpp.frame.mainpanes.scriptpanes.scriptSW.script.xpp-Search-and-Replace.search-replace-paned.replace-form.becomes-selection	XmPushButton
xpp.frame.mainpanes.scriptpanes.scriptSW.script.xpp-Search-and-Replace.search-replace-paned.replace-form.clear	XmPushButton
xpp.frame.mainpanes.scriptpanes.scriptSW.script.xpp-Search-and-Replace.search-replace-paned.replace-form.replace	XmPushButton
xpp.frame.mainpanes.scriptpanes.scriptSW.script.xpp-Search-and-Replace.search-replace-paned.replace-form.replace-all	XmPushButton
xpp.frame.mainpanes.scriptpanes.scriptSW.script.xpp-Search-and-Replace.search-replace-paned.replace-form.replace-and-backwards	XmPushButton
xpp.frame.mainpanes.scriptpanes.scriptSW.script.xpp-Search-and-Replace.search-replace-paned.replace-form.replace-and-forwards	XmPushButton
xpp.frame.mainpanes.scriptpanes.scriptSW.script.xpp-Search-and-Replace.search-replace-paned.replace.popup_popup-edit-menu	XmMenuShell
xpp.frame.mainpanes.scriptpanes.scriptSW.script.xpp-Search-and-Replace.search-replace-paned.replace.popup_popup-edit-menu.popup-edit-menu	XmRowColumn
xpp.frame.mainpanes.scriptpanes.scriptSW.script.xpp-Search-and-Replace.search-replace-paned.replace.popup_popup-edit-menu.popup-edit-menu.clear	XmPushButtonGadget
xpp.frame.mainpanes.scriptpanes.scriptSW.script.xpp-Search-and-Replace.search-replace-paned.replace.popup_popup-edit-menu.popup-edit-menu.copy	XmPushButtonGadget
xpp.frame.mainpanes.scriptpanes.scriptSW.script.xpp-Search-and-Replace.search-replace-paned.replace.popup_popup-edit-menu.popup-edit-menu.cut	XmPushButtonGadget
xpp.frame.mainpanes.scriptpanes.scriptSW.script.xpp-Search-and-Replace.search-replace-paned.replace.popup_popup-edit-menu.popup-edit-menu.paste	XmPushButtonGadget
xpp.frame.mainpanes.scriptpanes.scriptSW.script.xpp-Search-and-Replace.search-replace-paned.Sash	XmSash
xpp.frame.mainpanes.scriptpanes.scriptSW.script.xpp-Search-and-Replace.search-replace-paned.search-form	XmForm
xpp.frame.mainpanes.scriptpanes.scriptSW.script.xpp-Search-and-Replace.search-replace-paned.search-form.backwards	XmPushButton
xpp.frame.mainpanes.scriptpanes.scriptSW.script.xpp-Search-and-Replace.search-replace-paned.search-form.backwards-and-replace	XmPushButton
xpp.frame.mainpanes.scriptpanes.scriptSW.script.xpp-Search-and-Replace.search-replace-paned.search-form.becomes-selection	XmPushButton
xpp.frame.mainpanes.scriptpanes.scriptSW.script.xpp-Search-and-Replace.search-replace-paned.search-form.clear	XmPushButton
xpp.frame.mainpanes.scriptpanes.scriptSW.script.xpp-Search-and-Replace.search-replace-paned.search-form.forwards	XmPushButton
xpp.frame.mainpanes.scriptpanes.scriptSW.script.xpp-Search-and-Replace.search-replace-paned.search-form.forwards-and-replace	XmPushButton
xpp.frame.mainpanes.scriptpanes.scriptSW.script.xpp-Search-and-Replace.search-replace-paned.search-replace-action-form	XmForm
xpp.frame.mainpanes.scriptpanes.scriptSW.script.xpp-Search-and-Replace.search-replace-paned.search-replace-action-form.dismiss	XmPushButton
xpp.frame.mainpanes.scriptpanes.scriptSW.script.xpp-Search-and-Replace.search-replace-paned.search-replace-action-form.help	XmPushButton
xpp.frame.mainpanes.scriptpanes.scriptSW.script.xpp-Search-and-Replace.search-replace-paned.search-replace-action-form.options	XmPushButton
xpp.frame.mainpanes.scriptpanes.scriptSW.script.xpp-Search-and-Replace.search-replace-paned.search-text	XmText
xpp.frame.mainpanes.scriptpanes.scriptSW.script.xpp-Search-and-Replace.search-replace-paned.search-text.popup_popup-edit-menu	XmMenuShell
xpp.frame.mainpanes.scriptpanes.scriptSW.script.xpp-Search-and-Replace.search-replace-paned.search-text.popup_popup-edit-menu.popup-edit-menu	XmRowColumn
xpp.frame.mainpanes.scriptpanes.scriptSW.script.xpp-Search-and-Replace.search-replace-paned.search-text.popup_popup-edit-menu.popup-edit-menu.clear	XmPushButtonGadget
xpp.frame.mainpanes.scriptpanes.scriptSW.script.xpp-Search-and-Replace.search-replace-paned.search-text.popup_popup-edit-menu.popup-edit-menu.copy	XmPushButtonGadget
xpp.frame.mainpanes.scriptpanes.scriptSW.script.xpp-Search-and-Replace.search-replace-paned.search-text.popup_popup-edit-menu.popup-edit-menu.cut	XmPushButtonGadget
xpp.frame.mainpanes.scriptpanes.scriptSW.script.xpp-Search-and-Replace.search-replace-paned.search-text.popup_popup-edit-menu.popup-edit-menu.paste	XmPushButtonGadget
xpp.frame.mainpanes.scriptpanes.scriptSW.script.xpp-Search-and-Replace.search-replace-paned.Separator	XmSeparatorGadget
xpp.frame.mainpanes.scriptpanes.scriptSW.script.xpp-Templates	XmDialogShell
xpp.frame.mainpanes.scriptpanes.scriptSW.script.xpp-Templates.template-pane	XmPanedWindow
xpp.frame.mainpanes.scriptpanes.scriptSW.script.xpp-Templates.template-pane.help-form	XmForm
xpp.frame.mainpanes.scriptpanes.scriptSW.script.xpp-Templates.template-pane.help-form.Dismiss	XmPushButton
xpp.frame.mainpanes.scriptpanes.scriptSW.script.xpp-Templates.template-pane.help-form.Help	XmPushButton
xpp.frame.mainpanes.scriptpanes.scriptSW.script.xpp-Templates.template-pane.Sash	XmSash
xpp.frame.mainpanes.scriptpanes.scriptSW.script.xpp-Templates.template-pane.Separator	XmSeparatorGadget
xpp.frame.mainpanes.scriptpanes.scriptSW.script.xpp-Templates.template-pane.template_form	XmForm
xpp.frame.mainpanes.scriptpanes.scriptSW.script.xpp-Templates.template-pane.template_form.template_btn	XmPushButtonGadget
xpp.frame.mainpanes.scriptpanes.scriptSW.script.yes_no_popup	XmDialogShell
xpp.frame.mainpanes.scriptpanes.scriptSW.script.yes_no_popup.yes_no	XmMessageBox
xpp.frame.mainpanes.scriptpanes.scriptSW.script.yes_no_popup.yes_no.Cancel	XmPushButtonGadget
xpp.frame.mainpanes.scriptpanes.scriptSW.script.yes_no_popup.yes_no.Help	XmPushButtonGadget
xpp.frame.mainpanes.scriptpanes.scriptSW.script.yes_no_popup.yes_no.Message	XmLabelGadget
xpp.frame.mainpanes.scriptpanes.scriptSW.script.yes_no_popup.yes_no.OK	XmPushButtonGadget
xpp.frame.mainpanes.scriptpanes.scriptSW.script.yes_no_popup.yes_no.Separator	XmSeparatorGadget
xpp.frame.mainpanes.scriptpanes.scriptSW.script.yes_no_popup.yes_no.Symbol	XmLabelGadget
xpp.frame.mainpanes.scriptpanes.scriptSW.VertScrollBar	XmScrollBar
xpp.frame.mainpanes.scriptpanes.Separator	XmSeparatorGadget
xpp.frame.mainpanes.Separator	XmSeparatorGadget
xpp.frame.menubar	XmRowColumn
xpp.frame.menubar.command	XmCascadeButtonGadget
xpp.frame.menubar.edit	XmCascadeButtonGadget
xpp.frame.menubar.file	XmCascadeButtonGadget
xpp.frame.menubar.help	XmCascadeButtonGadget
xpp.frame.menubar.popup_file	XmMenuShell
xpp.frame.menubar.popup_file.command	XmRowColumn
xpp.frame.menubar.popup_file.command.""	XmSeparatorGadget
xpp.frame.menubar.popup_file.command.abandon	XmPushButtonGadget
xpp.frame.menubar.popup_file.command.execute-selection	XmPushButtonGadget
xpp.frame.menubar.popup_file.command.interrupt	XmPushButtonGadget
xpp.frame.menubar.popup_file.command.kill	XmPushButtonGadget
xpp.frame.menubar.popup_file.command.restart	XmPushButtonGadget
xpp.frame.menubar.popup_file.command.return	XmPushButtonGadget
xpp.frame.menubar.popup_file.command.semicolon	XmPushButtonGadget
xpp.frame.menubar.popup_file.edit	XmRowColumn
xpp.frame.menubar.popup_file.edit.clear	XmPushButtonGadget
xpp.frame.menubar.popup_file.edit.copy	XmPushButtonGadget
xpp.frame.menubar.popup_file.edit.cut	XmPushButtonGadget
xpp.frame.menubar.popup_file.edit.paste	XmPushButtonGadget
xpp.frame.menubar.popup_file.edit.redo	XmPushButtonGadget
xpp.frame.menubar.popup_file.edit.undo	XmPushButtonGadget
xpp.frame.menubar.popup_file.file	XmRowColumn
xpp.frame.menubar.popup_file.file.""	XmSeparatorGadget
xpp.frame.menubar.popup_file.file.empty-file	XmPushButtonGadget
xpp.frame.menubar.popup_file.file.include	XmPushButtonGadget
xpp.frame.menubar.popup_file.file.open	XmPushButtonGadget
xpp.frame.menubar.popup_file.file.quit	XmPushButtonGadget
xpp.frame.menubar.popup_file.file.reopen	XmCascadeButtonGadget
xpp.frame.menubar.popup_file.file.revert	XmPushButtonGadget
xpp.frame.menubar.popup_file.file.save	XmPushButtonGadget
xpp.frame.menubar.popup_file.file.save-as	XmPushButtonGadget
xpp.frame.menubar.popup_file.file.save-selection-as	XmPushButtonGadget
xpp.frame.menubar.popup_file.help	XmRowColumn
xpp.frame.menubar.popup_file.help.about-xpp	XmPushButtonGadget
xpp.frame.menubar.popup_file.help.command-menu	XmPushButtonGadget
xpp.frame.menubar.popup_file.help.edit-menu	XmPushButtonGadget
xpp.frame.menubar.popup_file.help.file-menu	XmPushButtonGadget
xpp.frame.menubar.popup_file.help.file-name-bar	XmPushButtonGadget
xpp.frame.menubar.popup_file.help.tools-menu	XmPushButtonGadget
xpp.frame.menubar.popup_file.help.tutorial	XmPushButtonGadget
xpp.frame.menubar.popup_file.help.using-help	XmPushButtonGadget
xpp.frame.menubar.popup_file.tools	XmRowColumn
xpp.frame.menubar.popup_file.tools.command-line	XmPushButtonGadget
xpp.frame.menubar.popup_file.tools.new-command-session	XmPushButtonGadget
xpp.frame.menubar.popup_file.tools.new-editor-session	XmPushButtonGadget
xpp.frame.menubar.popup_file.tools.options	XmPushButtonGadget
xpp.frame.menubar.popup_file.tools.palette	XmPushButtonGadget
xpp.frame.menubar.popup_file.tools.search-and-replace	XmPushButtonGadget
xpp.frame.menubar.popup_file.tools.templates	XmPushButtonGadget
xpp.frame.menubar.tools	XmCascadeButtonGadget
xpp.frame.Separator1	XmSeparatorGadget
xpp.frame.Separator2	XmSeparatorGadget
xpp.frame.Separator3	XmSeparatorGadget
xpp.xpp-Command-Line	TransientShell
xpp.xpp-Command-Line.command-paned	XmPanedWindow
xpp.xpp-Command-Line.command-paned.command_line_form	XmForm
xpp.xpp-Command-Line.command-paned.command_line_form.Add	XmPushButton
xpp.xpp-Command-Line.command-paned.command_line_form.Delete	XmPushButton
xpp.xpp-Command-Line.command-paned.command_line_form.Dismiss	XmPushButton
xpp.xpp-Command-Line.command-paned.command_line_form.Execute	XmPushButton
xpp.xpp-Command-Line.command-paned.command_line_form.Help	XmPushButton
xpp.xpp-Command-Line.command-paned.command-listSW	XmScrolledWindow
xpp.xpp-Command-Line.command-paned.command-listSW.command-list	XmList
xpp.xpp-Command-Line.command-paned.command-listSW.HorScrollBar	XmScrollBar
xpp.xpp-Command-Line.command-paned.command-listSW.VertScrollBar	XmScrollBar
xpp.xpp-Command-Line.command-paned.command-text	XmText
xpp.xpp-Command-Line.command-paned.command-text.popup_popup-edit-menu	XmMenuShell
xpp.xpp-Command-Line.command-paned.command-text.popup_popup-edit-menu.popup-edit-menu	XmRowColumn
xpp.xpp-Command-Line.command-paned.command-text.popup_popup-edit-menu.popup-edit-menu.clear	XmPushButtonGadget
xpp.xpp-Command-Line.command-paned.command-text.popup_popup-edit-menu.popup-edit-menu.copy	XmPushButtonGadget
xpp.xpp-Command-Line.command-paned.command-text.popup_popup-edit-menu.popup-edit-menu.cut	XmPushButtonGadget
xpp.xpp-Command-Line.command-paned.command-text.popup_popup-edit-menu.popup-edit-menu.paste	XmPushButtonGadget
xpp.xpp-Command-Line.command-paned.Sash	XmSash
xpp.xpp-Command-Line.command-paned.Separator	XmSeparatorGadget
xpp.xpp-Help	XmDialogShell
xpp.xpp-Help.pane	XmPanedWindow
xpp.xpp-Help.pane.form	XmForm
xpp.xpp-Help.pane.form.Dismiss	XmPushButtonGadget
xpp.xpp-Help.pane.help-textSW	XmScrolledWindow
xpp.xpp-Help.pane.help-textSW.help-text	XmText
xpp.xpp-Help.pane.help-textSW.help-text.popup_popup-edit-menu	XmMenuShell
xpp.xpp-Help.pane.help-textSW.help-text.popup_popup-edit-menu.popup-edit-menu	XmRowColumn
xpp.xpp-Help.pane.help-textSW.help-text.popup_popup-edit-menu.popup-edit-menu.clear	XmPushButtonGadget
xpp.xpp-Help.pane.help-textSW.help-text.popup_popup-edit-menu.popup-edit-menu.copy	XmPushButtonGadget
xpp.xpp-Help.pane.help-textSW.VertScrollBar	XmScrollBar
xpp.xpp-Help.pane.Sash	XmSash
xpp.xpp-Help.pane.Separator	XmSeparatorGadget
xpp.xpp-Start-up-Options_popup	XmDialogShell
xpp.xpp-Start-up-Options_popup.xpp-Start-up-Options	XmFileSelectionBox
xpp.xpp-Start-up-Options_popup.xpp-Start-up-Options.Apply	XmPushButtonGadget
xpp.xpp-Start-up-Options_popup.xpp-Start-up-Options.Cancel	XmPushButtonGadget
xpp.xpp-Start-up-Options_popup.xpp-Start-up-Options.command-line-form	XmForm
xpp.xpp-Start-up-Options_popup.xpp-Start-up-Options.command-line-form.command-line-label:	XmLabel
xpp.xpp-Start-up-Options_popup.xpp-Start-up-Options.command-line-form.startup-command-line	XmTextField
xpp.xpp-Start-up-Options_popup.xpp-Start-up-Options.Dir	XmLabelGadget
xpp.xpp-Start-up-Options_popup.xpp-Start-up-Options.DirListSW	XmScrolledWindow
xpp.xpp-Start-up-Options_popup.xpp-Start-up-Options.DirListSW.DirList	XmList
xpp.xpp-Start-up-Options_popup.xpp-Start-up-Options.DirListSW.HorScrollBar	XmScrollBar
xpp.xpp-Start-up-Options_popup.xpp-Start-up-Options.DirListSW.VertScrollBar	XmScrollBar
xpp.xpp-Start-up-Options_popup.xpp-Start-up-Options.empty-file	XmPushButton
xpp.xpp-Start-up-Options_popup.xpp-Start-up-Options.FilterLabel	XmLabelGadget
xpp.xpp-Start-up-Options_popup.xpp-Start-up-Options.FilterText	XmTextField
xpp.xpp-Start-up-Options_popup.xpp-Start-up-Options.Help	XmPushButtonGadget
xpp.xpp-Start-up-Options_popup.xpp-Start-up-Options.Items	XmLabelGadget
xpp.xpp-Start-up-Options_popup.xpp-Start-up-Options.ItemsListSW	XmScrolledWindow
xpp.xpp-Start-up-Options_popup.xpp-Start-up-Options.ItemsListSW.HorScrollBar	XmScrollBar
xpp.xpp-Start-up-Options_popup.xpp-Start-up-Options.ItemsListSW.ItemsList	XmList
xpp.xpp-Start-up-Options_popup.xpp-Start-up-Options.ItemsListSW.VertScrollBar	XmScrollBar
xpp.xpp-Start-up-Options_popup.xpp-Start-up-Options.OK	XmPushButtonGadget
xpp.xpp-Start-up-Options_popup.xpp-Start-up-Options.Selection	XmLabelGadget
xpp.xpp-Start-up-Options_popup.xpp-Start-up-Options.Separator	XmSeparatorGadget
xpp.xpp-Start-up-Options_popup.xpp-Start-up-Options.Text	XmTextField
xpp.yes_no_popup	XmDialogShell
xpp.yes_no_popup.yes_no	XmMessageBox
xpp.yes_no_popup.yes_no.Cancel	XmPushButtonGadget
xpp.yes_no_popup.yes_no.Help	XmPushButtonGadget
xpp.yes_no_popup.yes_no.Message	XmLabelGadget
xpp.yes_no_popup.yes_no.OK	XmPushButtonGadget
xpp.yes_no_popup.yes_no.Separator	XmSeparatorGadget
xpp.yes_no_popup.yes_no.Symbol	XmLabelGadget
